434434434434
233340043332
223400004322
233340043332
434434434434
001110011100