222211112222
101100001101
100122221001
101100001101
222215512222
111001100111
001120021100