001110011100
011112211110
115123321511
111235532111
011123321110
005112211500
000315513000
000033330000
