444344443444
001234432100
441100001144
001211112100
114333333411
443000000344
