434534435434
233340043332
253405504352
233340043332
434434434434
001110011100