007170071700
011112211110
115123321511
111257752111
011123321110
005112211500
000315513000
000033330000
