444344443444
001234432100
451100001154
001511115100
114335533411
443000000344
