00111001110
01111111111
11111111111
11111111111
01111111110
00111111100
00011111000
00001110000
