44434443444
00123432100
44110001144
00121112100
11433333411
44300000344
