000001000000
000011100000
000111110000
001111111000
011111111100
001111111000
000111110000
000011100000
000001000000
