22221112222
10110001101
10002220001
10110001101
22221112222