434534435434
237340043732
257705507752
233340043332
434474474434
001110011100
717204402717
001430034100