43443434434
23334043332
22340004322
23334043332
43443434434