00111011100
01111211110
11112321111
11123332111
01112321110
00311211300
00031213000
00003330000
