222211112222
101100001101
100022220001
101100001101
222215512222
111001100111