001110011100
011112211110
111123321111
111233332111
011123321110
003112211300
000312213000
000033330000
