44400000444
00123432100
44110001144
00121112100
11400000411
44000000044
